@@@@@@@@@@@@@@@@@@@@@@@@@
@-------------ee--------@
@9999--------*33--------@
@--p-e--ee--------------@
1211224411----------0---@---+
@################66666666687678
@###################%########@###
@-----------------------@