@@@@@@@@@@@@@@@@@@@@@@@@@
@----------------------@
@------------------@
@--p----------b----@
@------------------@
@--------------0---@
@------------------@
@------------------@
@------------------@
@------------------@
@------------------@
@_--_--_--_--_--_--_--_--_--_--_@